LAN_Test Test
// en: generic English


.LAN_SiteTitle	Fight For Freedom Management Background
#LAN_Slogan		 Fight For Freedom @ GaeaMobile
#LAN_FffMunuName Fight For Freedom


#LAN_SysConfig		System Config
#LAN_UserPrivilegeManagement	User&Privilege
#LAN_GameManagement		Game Management	
#LAN_ArticleManagement	Column&Article
#LAN_MaterialStation	Material Station



.LAN_Welcom		Welcom
.LAN_ModifyUserinfo		Modify Userinfo
.LAN_ModifyPassword		Change Password
.LAN_Quit			Log out
.LAN_Login			Login
.LAN_More			More
.LAN_All	All
.LAN_Time	Time
.LAN_Detail	Detail
.LAN_Back	Back
.LAN_User	User
.LAN_Nickname	Nickname
.LAN_UserName	User Name
.LAN_Password	Password
.LAN_Userpoint Userpoint
.LAN_Old	Old
.LAN_New	New
.LAN_Create Create
.LAN_Update Update
.LAN_Email	Email
.LAN_Mobile	Mobile
.LAN_Gender Gender
.LAN_Man	Man
.LAN_Woman	Woman
.LAN_View	View
.LAN_Show	Show
.LAN_OK	OK
.LAN_Submit	Submit
.LAN_Cancel	Cancel
.LAN_Yes	Yes
.LAN_No	No
.LAN_Reset	Reset
.LAN_Confirm	Confirm
.LAN_Register	Register
.LAN_Add	Add
.LAN_Edit	Edit
.LAN_Delete	Delete
.LAN_Operation	Operation
.LAN_Management	Management
.LAN_Role	Role
.LAN_Privilege	Privilege
.LAN_Pattern	Pattern
.LAN_Intro	Intro
.LAN_Content	Content
.LAN_Level	Level
.LAN_Order	Order
.LAN_Parent	Parent
.LAN_News	News
.LAN_Video	Video
.LAN_Audio	Audio	
.LAN_Media	Media


.LAN_FiltByHero	Filt by hero
.LAN_FiltByCatalog	Filt by catalog
.LAN_UploadImage	Upload Image
.LAN_UploadVideo	Upload Video
.LAN_OutLink	Out Link
.LAN_ConfirmToDelete	Confirm Delete? (click summit to take effect when confirmed)
.LAN_ParamIncomplete	Param Incomplete
.LAN_MemberManagement	Member Management
.LAN_TagManagement	Tag Management
.LAN_BackgroundUserManagement	Background User Management
.LAN_BackgroundUserManagement	Background User Management
.LAN_RoleManagement	Role Management
.LAN_PrivilegeManagement	Privilege Management
.LAN_SpecialPrivilege	Special Privilege
.LAN_SystemVariables	System Variables
.LAN_OperationLog	OperationLog

.LAN_ColumnManagement	Column Management
.LAN_ArticleManagement	Article Management
.LAN_AllArticles	All Articles
.LAN_ColumnSubtitle	 (Don't delete. Up to six levels are permitted.)
.LAN_Subnodes	Subnodes
.LAN_AddSubnode	Add Subnode
.LAN_ArticleInfomation Article Infomation
.LAN_Events Events
.LAN_Strategy Strategy 
.LAN_PleaseSelectCatalog Please Select Catalog
.LAN_Hero Hero
.LAN_Equipment	Equipment
.LAN_SentStone	Sent Stone
.LAN_Talent	Talent	
.LAN_Honor	Honor
.LAN_Skill	Skill
.LAN_Picture	Picture
.LAN_PhysicalAttack	PhysicalAttack
.LAN_MagicAttack	MagicAttack
.LAN_Defence	Defence
.LAN_LearnDifficulty	LearnDifficulty
.LAN_MediaSubtitle (The same group have the same name. Out link is preferred)
.LAN_EditGroup Edit Group



//datatables 
.LAN_Group	Group
.LAN_Name	Name
.LAN_Value	Value
.LAN_Type	Type
.LAN_Integer Integer
.LAN_Float	Float
.LAN_String	String

.LAN_Type	Type
.LAN_OperationIntro	Operation Intro
.LAN_OperationTime	Operation Time
.LAN_ViewDetails	View Details
.LAN_OperationUser	Operation User
.LAN_PrevirousSnapshort Previrous Snapshort
.LAN_CurentSnapshort	Curent Snapshort
